
 WWWWWWWWWWWF
 WFFFFFFFFFW
 WFFFFDFFFFW
 WFFFFCFFFFW
 WFFFFFFFFFW
 WFDCFSFCDFW
 WFFFFFFFFFW
 WFFFFCFFFFW
 WFFFFDFFFFW
 WFFFFFFFFFW
 WWWWWWWWWWW
