
 WWWWWWWWWW 
 WFFFFFFFFW
 WFSDCCFCDW
 WFFFDFFCDW
 WWWWWWFFFW
      WDFFW
      WFCCW
      WDFFW
      WWWWW
