
  WWWWW
 WWDCDWW
 WDFFFFW 
 WWCFCDW
 WDCCFWW
 WWDCCW
  WWSDW
   WWWW
