
 WWWWWWWWWWWWF
 WFFFCDFFDFFW
 WFFCDFFCFCFW
 WWWWWCCWFFFW
     WDFWCCFW
     WCFWSCFW
     WDFDWWFW
     WDFDFFFW
     WDFFFFFW
     WDFFFCDW
     WWWWWWWW
