WWWWWWWWWWWW
WFFFFFFFFFFW
WFFFDFFFFFFW
WFFFFFFFFFFW
WFFFFFFFFFFW
WFFFFFFSFFFW
WFFFFFFFFFFW
WFFFFFFFFFFW
WFFFFFCFFFFW
WFFFFFFFFFFW
WFFFFFFFFFFW
WWWWWWWWWWWW