
 WWWWWWWWWWWF
 WSCDFFFFFFW
 WCCCDFFFFFW
 WDDCCDFFFFW
 WFFDCCDFFFW
 WFFFDCCDFFW
 WFFFFDCCDFW
 WFFFFFDCCDW
 WFFFFFFDCFW
 WFFFFFFFDFW
 WWWWWWWWWWW
