WWWWWWWWWWWWFFFFFFFFFWWWWWWWWFFFFFF
WFDFFFFFFFFWFFFFFFFFFWFFFFFFW
WFFFFFFFCFFWFFFFFFFFFWFFFFFFW
WFFFFFCFFFFWFFFFFFFFFWFFFFFFW
WFFFFFFFSFFWFFFFFFFFFWFFFFFFW
WFFFFFFFFFFW         WWWWWWWW
WFFFFFFFFFFW
WFFDFFFFFFFWFFFFWWWWWWW
WFFFFFFFFFFWFFFFWFFFFFW
WFFCFFFFDFFWFFFFWFFFFFW
WFFFFFFFFFFWFFFFWFFFFFW
WWWWWWWWWWWWFFFFWFFFFFW
FFFFFFFFFFFFFFFFWFFFFFW
FFFFFFFFFFFFFFFFWFFFFFW
FFFFFFFFFFFFFFFFWWWWWWW
FFFFF
FFFFFFFF
FFFFFFFFFFFFFFFFFFFFFFFFFFF