WWWWWWWWW
WDFFWFFDW
WFCFWFCFW
WFCFWFCFW
WFCFWFCFW
WFFFWFFFW
WWFWWWFWW
WDFFWDCFW
WDFFWFCFW
WCCCWDCDW
WDFFFFFFW
WFFFCFDDW
WWWFCFWWW
WWDFSFDWW
WWDFFFDWW
WWWWWWWWW