
 WWWWWWWWWWWF
 WSCFFDFCFDW
 WFCFFDFCDFW
 WWWWWWWWFFW
 WFFFDCFFFCW
 WCFCFFFCDDW
 WDDWWWWWWWW
 WFFFFCFDFFW
 WFDCFFFCFFW
 WFWWWCWWWFW
 WDCDFFFFFDW
 WWWWWWWWWWW
