WWWWWWWWW
WDCFWFFDW
WFCFWFCFW
WFCFWFCFW
WDCFWFCFW
WFFFWFFFW
WWFWWWFWW
WDFFWDCFW
WDFFWFCFW
WCCCWDCDW
WDFFCFFFW
WDFFCFDDW
WWWFCFWWW
WWDFSFDWW
WWDFFFDWW
WWWWWWWWW